24 92 134 134 134 134 134 134 134 134 134 134 134 134 134 134 134 134 134 134 134 134 134 134 134 134 134 134 134 134 134 93 -2
24 113 36 37 0 0 0 0 0 0 0 0 0 0 0 0 0 0 0 0 0 0 0 0 0 0 0 0 0 0 0 23 -2
24 113 58 59 0 0 0 0 0 0 0 0 0 0 0 0 0 0 0 0 0 0 0 0 0 0 0 0 0 0 0 23 -2
24 113 0 0 0 0 0 0 0 0 0 0 0 0 0 0 0 0 0 0 0 0 0 0 0 0 0 0 0 0 0 23 -2
24 113 0 0 0 0 0 0 0 0 0 0 0 0 0 0 0 0 0 0 0 0 0 0 0 0 0 0 0 0 0 23 -2
24 113 0 0 0 0 0 0 0 0 0 0 0 0 0 0 0 0 0 0 0 0 0 0 0 0 0 0 0 0 0 23 -2
24 113 0 0 0 0 0 0 0 0 0 0 0 0 0 0 0 0 0 0 0 0 0 0 0 0 0 0 0 0 35 23 -2
24 113 0 0 0 0 0 0 0 0 0 0 0 0 0 0 0 0 0 0 0 0 0 0 0 0 0 7 8 8 9 23 -2
92 135 0 0 0 0 0 0 0 0 0 0 0 0 0 0 0 0 0 0 0 0 0 0 0 0 0 29 30 30 31 23 -2
113 7 8 8 8 9 0 0 0 0 0 0 0 0 0 0 0 0 0 0 0 0 0 0 0 0 0 29 30 30 31 23 -2
113 29 30 30 30 31 0 0 0 0 0 0 0 0 0 0 0 0 0 0 0 0 0 0 0 0 0 29 30 30 31 23 -2
113 29 30 30 30 31 0 0 0 0 0 0 0 0 0 0 0 0 0 0 0 0 0 0 0 0 0 29 30 30 31 23 -2
113 29 30 30 30 31 0 0 0 0 0 0 0 0 0 0 0 0 0 0 0 0 0 0 0 0 35 29 30 30 31 23 -2
113 29 30 16 32 8 8 9 0 0 0 0 0 0 0 0 0 0 0 0 0 0 0 7 8 8 8 33 30 30 35 23 -2
113 51 35 60 52 35 30 7 8 9 0 0 0 0 0 0 0 0 0 0 7 8 8 33 30 30 30 30 30 36 37 23 -2
114 2 2 2 2 2 2 2 2 2 2 2 2 2 2 2 2 2 2 3 51 52 52 52 52 52 52 52 52 58 59 23 -2
24 24 24 24 24 24 24 24 24 24 24 24 24 24 24 24 24 24 24 26 2 2 2 2 2 2 2 2 2 2 2 23 -2